xxxxxxxxxxxxxxxxxx
x................s
x................x
x................x
x................x
x................x
x................x
xe...............x
xxxxxxxxxxxxxxxxxx